-----     -----
|...|     |...+
|...+#####+...|
|...|  #  |...|
-----  #  -----
      -+-      
      |.|      
      ---      
